label	drawings	engraving	iconography	painting	sculpture	total
String instrument accessory	1	0	0	0	0	1
Château	3	2	0	0	0	5
Armored cruiser	0	1	0	0	0	1
Figure drawing	239	49	0	1	5	294
Style	22	14	3	9	3	51
Fir	0	1	0	1	0	2
Craft	0	0	1	0	0	1
Night	0	0	0	3	2	5
Elk	0	0	0	0	1	1
Athletic dance move	0	0	0	0	1	1
Ancient greek temple	1	0	0	0	0	1
Black cat	1	0	0	1	0	2
Metropolitan area	2	0	0	0	2	4
Plaza	4	0	0	0	0	4
Yoga	0	0	0	0	1	1
Building	72	54	1	48	14	189
Classical architecture	14	10	0	0	8	32
Bin bag	0	0	0	0	1	1
Mouth	1	0	0	0	7	8
Ruffed grouse	0	1	0	0	0	1
Rose	4	0	0	0	1	5
Relief	13	7	352	0	39	411
Giraffe	0	0	0	1	6	7
Harp	0	0	0	2	0	2
Bronze	0	0	70	4	311	385
Bird-of-paradise	0	1	0	0	0	1
Logo	0	0	1	0	1	2
Artwork	401	149	22	46	44	662
Chess	0	0	0	0	1	1
Spring	0	0	0	0	3	3
Recreation	10	5	1	15	39	70
Street	5	3	0	0	1	9
Line	23	5	1	2	0	31
Palace	7	4	0	7	0	18
Crystal	0	0	0	0	1	1
Art exhibition	0	0	2	0	6	8
Coast	2	0	0	16	1	19
Violin	0	0	0	1	0	1
Coffee cup	1	0	0	0	0	1
Elephant	1	1	1	1	9	13
Buckle	0	0	2	0	0	2
Candle holder	0	0	0	0	1	1
Cheek	22	0	24	122	12	180
Shot put	0	0	0	0	4	4
Bone	0	2	0	0	2	4
Chicken	1	0	0	0	0	1
Lion	2	1	0	1	33	37
Hug	1	0	0	0	0	1
Product	2	0	2	1	2	7
Official	0	0	0	1	0	1
Plant	119	113	4	22	213	471
Bottle	1	0	0	1	0	2
Dish	0	0	0	1	0	1
Army	1	0	0	0	0	1
Trunk	4	6	1	1	35	47
european water shrew	0	1	0	0	0	1
Symmetry	0	2	0	0	2	4
Morning	0	0	0	14	0	14
Beak	1	5	0	0	5	11
Male	4	4	0	6	13	27
Carving	7	2	262	1	532	804
Jade	0	0	0	0	2	2
Seal	1	0	0	0	1	2
Holy places	15	17	184	16	2	234
Convent	0	1	7	1	0	9
Calm	1	0	0	20	0	21
Square	2	2	17	3	0	24
earthenware	0	0	0	0	2	2
Mythical creature	6	1	0	0	3	10
Christmas eve	1	0	1	0	0	2
Tall ship	3	1	0	3	0	7
Real estate	0	0	0	0	4	4
Origami	0	0	0	0	1	1
Uniform	3	0	0	8	0	11
Velociraptor	0	0	0	0	1	1
Dishware	0	0	1	7	0	8
Cola	1	0	0	0	0	1
Lady's maid	0	0	0	1	0	1
Attic	0	0	0	1	0	1
Moustache	3	4	22	4	1	34
Synagogue	0	0	0	2	0	2
Ruins	6	13	0	5	1	25
Gothic architecture	0	2	0	0	0	2
Inlet	0	0	0	1	0	1
Circle	3	5	2	15	9	34
Still life	65	25	174	273	1	538
Haute couture	0	0	0	1	0	1
Vintage car	8	0	0	0	0	8
Walrus	1	0	0	0	0	1
Herd	0	0	0	3	0	3
Cut flowers	12	0	0	0	0	12
Quilting	0	0	1	1	0	2
Tololoche	0	0	0	2	0	2
Friar	0	0	2	0	0	2
Tent	0	0	0	0	1	1
Cross	0	0	5	0	4	9
Harvest	0	0	0	1	0	1
Team	0	1	0	0	2	3
Pray	0	0	21	0	0	21
Balance	0	0	0	0	10	10
Violone	0	0	0	2	1	3
Menorah	0	0	0	0	1	1
Sumatran rhinoceros	0	1	0	0	1	2
Linens	1	0	0	1	0	2
Electricity	0	1	0	0	1	2
Hip	0	0	0	0	2	2
Foal	0	0	0	1	0	1
Sketch	615	220	1	3	6	845
Bufo	1	0	0	0	0	1
Lake district	0	0	0	2	0	2
City	29	17	0	37	12	95
Back	0	0	0	0	2	2
Sphere	0	0	0	0	19	19
Whale	1	0	0	0	0	1
Root	0	1	0	0	0	1
Galiot	2	4	0	2	0	8
Lobby	0	1	0	0	0	1
Iris	5	0	0	14	0	19
Extreme sport	0	0	0	1	1	2
Earth	0	0	0	1	0	1
Musical	0	0	0	1	0	1
Ancient dog breeds	4	5	0	3	7	19
Warlord	3	0	0	0	1	4
Sibling	1	0	0	0	0	1
Bed	0	0	0	2	0	2
Fishmonger	0	1	0	0	0	1
Volcanic field	0	0	0	1	0	1
Workhouse	0	1	0	0	0	1
Wild cat	0	1	0	0	0	1
Transmission tower	0	0	0	0	1	1
Lighthouse	0	1	0	0	0	1
Jeans	0	0	0	1	1	2
Standing	34	2	0	6	112	154
Easter egg	0	0	0	0	1	1
Choreography	0	0	0	1	0	1
Museum	0	0	4	0	44	48
Ear	1	1	2	2	5	11
great grey owl	0	2	0	0	0	2
Printmaking	63	250	0	0	0	313
Footwear	8	1	0	2	9	20
Houseplant	0	0	0	0	8	8
Lake	0	0	0	4	0	4
Beetle	0	1	0	0	0	1
Hat	1	0	0	3	0	4
Serpent	1	0	0	0	1	2
Platter	0	0	1	1	0	2
Bicycle	0	0	0	0	2	2
Beach	0	0	0	0	1	1
Exercise equipment	0	0	0	0	1	1
Protected cruiser	2	0	0	0	0	2
Pastel	0	0	0	1	0	1
Mare	1	0	0	1	3	5
Construction paper	0	0	0	1	0	1
Graffiti	7	1	0	4	0	12
Victorian fashion	18	5	0	119	0	142
Nature	6	1	0	46	13	66
Performance art	0	0	0	0	4	4
Pianist	3	0	0	3	0	6
Bishop	0	0	3	0	0	3
Door	1	0	2	1	1	5
Violinist	0	0	0	1	0	1
Haze	1	0	0	3	0	4
Zoo	0	0	0	0	6	6
Jaw	70	6	0	9	43	128
Ceremony	1	0	4	1	0	6
High priest	1	0	99	7	0	107
Ox	0	0	0	0	2	2
Yard	0	0	0	0	21	21
Skyscraper	1	0	0	0	2	3
Bovine	2	4	0	2	4	12
Puzzle	0	0	1	0	0	1
Boxer	1	0	0	0	0	1
Muscle	17	4	0	2	97	120
Window	1	0	1	0	1	3
Car	10	1	0	0	1	12
Water bird	3	1	0	0	3	7
Small to medium-sized cats	1	4	0	0	2	7
Stretching	0	0	0	0	2	2
National monument	0	0	0	0	3	3
Toy	0	0	0	96	45	141
Storm	0	0	0	5	0	5
Flautist	1	0	0	1	0	2
Stuffed toy	0	0	0	0	2	2
Asphalt	0	0	0	0	1	1
Vase	0	1	0	0	10	11
Visual arts	254	149	723	1116	110	2352
Skyline	1	0	0	0	1	2
Hall	0	0	0	1	0	1
Biome	1	2	0	9	4	16
Comics	15	2	1	0	0	18
Grove	0	2	0	0	0	2
Child art	6	0	0	11	0	17
Hill	0	1	0	3	0	4
Park	0	0	0	0	20	20
Galápagos tortoise	0	1	0	0	2	3
Basketball hoop	0	0	0	0	1	1
Darkness	1	2	1	9	2	15
Stone wall	0	0	0	0	1	1
Stately home	2	1	0	6	0	9
Silk	0	0	0	1	0	1
Roar	0	0	0	0	1	1
Sand	1	0	0	1	38	40
Ballroom	0	0	0	1	0	1
Subcompact car	0	0	0	0	1	1
Hay	0	0	0	1	0	1
Tile	0	0	1	2	0	3
Environmental art	2	0	0	1	87	90
Guru	1	0	32	0	1	34
Baggage	0	0	0	0	1	1
Loggerhead sea turtle	0	1	0	0	0	1
Valley	0	0	0	2	0	2
Bob cut	0	1	0	0	0	1
Obelisk	2	0	0	0	1	3
Cuisine	0	0	0	2	0	2
Monument	4	1	0	0	605	610
Yard globe	0	0	0	0	3	3
English riding	4	0	0	0	0	4
Bulldog	1	1	0	0	0	2
Smoking accessory	0	0	1	0	0	1
Freight transport	0	0	0	2	0	2
Shar pei	0	0	0	0	2	2
Fencing	2	0	0	0	1	3
Ecoregion	0	1	0	13	0	14
Urn	0	0	0	0	1	1
Big cats	2	1	0	0	17	20
Swan	0	0	0	0	5	5
Mosque	1	0	0	0	0	1
Skull	0	2	0	0	4	6
Grass family	2	1	0	4	2	9
Snail	0	1	0	0	1	2
Gravel	0	0	0	0	1	1
Composer	0	0	0	1	0	1
Art book	1	0	0	0	0	1
Bird bath	0	0	0	0	1	1
Event	5	0	1	18	0	24
Kettlebell	0	0	0	0	1	1
Peterbald	0	0	0	0	1	1
Sunlight	0	0	0	1	2	3
Castle	2	1	0	1	1	5
Soft drink	1	0	0	0	0	1
Prophet	12	46	914	146	2	1120
Ship of the line	4	3	0	1	0	8
Tableware	3	1	3	14	0	21
Landmark	8	12	0	0	94	114
Motorcycle	2	0	0	1	0	3
Shoulder	3	0	0	0	17	20
Brass	1	0	136	2	22	161
Brig	1	0	0	0	0	1
Turban	1	0	6	1	0	8
Pole dance	0	0	0	0	1	1
Ice	0	0	0	0	5	5
Air travel	0	0	0	1	0	1
Panorama	0	1	0	7	0	8
Headpiece	3	1	1	22	1	28
Aerospace engineering	0	0	0	1	1	2
Bonnet	1	0	0	1	0	2
Metropolitan bishop	0	0	10	4	0	14
Wind	0	0	0	8	4	12
Joint	11	0	0	0	44	55
Church	2	5	5	0	0	12
Insect	0	1	0	0	0	1
Frost	1	0	0	0	0	1
Exhibition	0	0	2	0	1	3
Sunflower	0	0	0	1	0	1
Masai lion	1	0	0	0	0	1
Tire	0	0	0	0	1	1
Urban design	0	0	0	0	5	5
Rim	0	1	0	0	2	3
Sheep	0	1	0	0	0	1
Goat	1	0	0	0	1	2
Daughter	2	0	1	1	0	4
Wildflower	3	1	0	1	0	5
Temple	3	0	58	2	17	80
Mode of transport	6	0	0	1	0	7
Pointe shoe	0	0	0	0	1	1
Fishing vessel	0	1	0	0	0	1
Spoke	0	1	0	0	0	1
Water castle	1	0	0	0	0	1
Monochrome photography	12	9	0	1	17	39
Award	0	0	0	0	1	1
Mother	6	0	1	2	0	9
Action figure	0	0	0	0	14	14
Floristry	7	0	0	0	0	7
Machine	0	0	0	0	5	5
Auto part	2	0	0	0	2	4
Technical drawing	1	0	0	0	0	1
Dog breed	7	0	0	2	4	13
Drink	1	0	0	0	0	1
Shrub	0	0	0	1	9	10
Town square	2	0	0	0	0	2
Sea	4	0	0	29	6	39
Headgear	11	4	6	15	3	39
Shrine	0	0	66	0	0	66
Meerkat	0	0	0	0	2	2
Dressage	4	0	0	2	0	6
Ballet tutu	0	0	0	0	1	1
Metal	4	2	283	6	454	749
Statue	2	1	29	2	1462	1496
Sedan	1	0	0	0	0	1
Anteater	1	0	0	0	0	1
Byzantine architecture	2	2	0	0	0	4
Rectangle	5	4	95	5	0	109
Music	0	0	0	2	0	2
Bison	0	0	0	0	1	1
Dining room	1	0	0	0	0	1
Rust	0	0	0	1	0	1
Transparent material	0	0	0	0	2	2
Veena	0	0	2	2	0	4
Throwing	0	0	0	0	8	8
Figurine	0	0	9	98	711	818
Locket	0	0	6	12	0	18
Human anatomy	3	0	1	0	6	10
Miniature	9	7	482	0	10	508
Number	0	0	0	1	3	4
English lavender	0	0	0	1	0	1
Pineapple	0	0	0	1	0	1
Mural	19	2	37	41	1	100
Aerial photography	1	1	0	0	0	2
Batman	2	0	0	0	2	4
Monarchy	0	0	4	7	0	11
Magenta	2	0	2	1	0	5
Marine biology	0	0	0	0	1	1
Copper	0	0	6	0	2	8
Elder	0	0	7	30	0	37
Stork	0	1	0	0	0	1
Vegetarian food	2	0	0	0	0	2
Screenshot	0	0	1	1	1	3
Eating	1	0	0	0	0	1
Outdoor play equipment	0	0	0	0	2	2
Net	0	0	0	0	6	6
Archimandrite	0	0	2	5	0	7
Meteorological phenomenon	0	0	0	1	0	1
Fontange	2	0	0	11	0	13
Animal sports	3	1	0	6	0	10
History	91	207	641	62	8	1009
Symbol	0	0	6	0	7	13
Public event	0	1	0	0	0	1
Barquentine	1	0	0	0	0	1
Horse supplies	2	2	0	0	0	4
Plastic arts	0	0	0	1	0	1
sunflower	0	0	0	1	0	1
Building sand castles	0	0	0	0	31	31
Elephants and Mammoths	1	1	0	0	9	11
Self-portrait	157	17	61	869	0	1104
Dance	1	0	0	2	11	14
Pond turtle	0	1	0	0	0	1
Mount scenery	0	0	0	1	0	1
Vacation	0	0	0	0	2	2
Basketball court	0	0	0	0	1	1
Target archery	0	0	0	0	1	1
Vegetation	0	1	0	2	0	3
Bugle	0	0	0	0	1	1
Light	0	0	0	2	1	3
Doll	0	0	0	99	0	99
Mortuary temple	0	0	0	0	1	1
Tourism	2	1	0	11	11	25
woodworking	0	0	0	0	6	6
Smoke	1	0	0	0	1	2
Brain	0	0	0	0	1	1
Indian rhinoceros	0	1	0	0	2	3
East indiaman	4	3	0	6	0	13
Anthurium	2	0	0	0	0	2
Naval ship	2	1	0	0	0	3
Wilderness	0	1	0	2	0	3
Segway	0	0	0	0	1	1
Terrestrial plant	0	0	0	0	1	1
Tail	4	2	0	1	11	18
Light fixture	0	0	0	0	5	5
Cloak	1	0	0	0	0	1
Infrastructure	1	0	0	0	0	1
Guillotine	1	3	0	0	0	4
Destroyer	2	0	0	0	0	2
Rodeo	0	1	0	0	0	1
Driftwood	0	0	0	0	9	9
Totem pole	0	0	0	0	3	3
People in nature	0	0	0	1	0	1
Konghou	0	0	0	2	0	2
Blizzard	5	0	0	3	0	8
Hare	3	1	0	0	7	11
Roof	0	0	0	0	1	1
Natural landscape	10	4	0	45	14	73
Plaster	0	0	0	0	9	9
Flower	29	10	1	7	9	56
Piano	0	0	0	1	0	1
Carmine	0	0	0	0	1	1
Wine bottle	0	0	0	1	0	1
Hortaya borzaya	1	0	0	1	0	2
Eye	5	1	3	96	1	106
Knight	12	8	0	0	0	20
Dromon	0	1	0	0	0	1
Clothes hanger	0	0	0	0	1	1
Drawing	776	451	13	113	28	1381
Tints and shades	1	0	0	0	0	1
Science	0	0	0	0	1	1
Memorial	0	1	1	0	95	97
Transport	1	1	0	0	1	3
Deacon	0	0	2	0	0	2
Blessing	0	1	37	0	0	38
Space	1	0	0	3	6	10
Muridae	1	0	0	0	0	1
Vehicle	60	59	0	65	12	196
Chariot	3	1	0	1	0	5
Natural environment	2	4	0	26	1	33
Shoe	4	1	0	1	6	12
Mushroom	2	0	0	0	1	3
Collage	0	0	1	1	1	3
Toddler	0	0	0	10	0	10
Horse and buggy	6	1	0	1	0	8
Egret	1	0	0	0	0	1
Mannequin	0	0	0	0	21	21
Llama	1	0	0	0	1	2
Russian spaniel	1	0	0	0	0	1
Shack	2	0	0	0	0	2
Amusement park	0	0	0	0	1	1
Stock photography	137	317	198	29	33	714
Modern art	68	37	289	103	46	543
Black hair	11	1	0	6	1	19
Dinner	1	0	0	0	0	1
Hunting dog	3	4	0	0	0	7
Bansuri	0	0	1	0	0	1
Delphinium	0	0	0	1	0	1
Tide	0	0	0	4	0	4
Technology	3	0	0	1	11	15
Horn	0	0	0	0	12	12
Carriage	5	0	0	0	0	5
Yellow	2	0	17	7	2	28
Whiteboard	1	0	0	0	0	1
Evening	0	0	0	12	0	12
Underwater	0	0	0	0	1	1
Cloud	3	1	0	24	8	36
Puffin	0	0	0	0	1	1
Formal wear	1	0	0	17	0	18
Coca-cola	1	0	0	0	0	1
Marines	0	0	0	1	0	1
Family	5	0	0	3	0	8
Rabbit	1	1	0	0	2	4
Sailing ship	6	7	0	4	0	17
Bear	1	0	0	0	0	1
Screech owl	0	1	0	0	0	1
Ballet master	0	0	0	1	0	1
Backyard	0	0	0	0	1	1
Picture frame	34	30	858	200	0	1122
Wood stain	0	0	7	0	1	8
Antelope	0	0	0	0	3	3
Schooner	0	2	0	4	0	6
Lilac	1	0	0	1	0	2
Vault	0	3	0	0	0	3
Fountain	0	0	0	0	13	13
Foot	1	0	0	0	0	1
Clipper	3	0	0	4	0	7
Snowy owl	0	0	0	0	1	1
Preacher	0	0	13	3	0	16
Coloring book	8	2	0	0	0	10
Green	3	0	1	4	13	21
Clàrsach	0	0	0	2	0	2
Coat	3	0	0	3	0	6
Bull	0	1	0	0	4	5
heater	0	0	0	0	1	1
Photomontage	0	0	0	0	1	1
Flowerpot	2	0	0	0	5	7
Triangle	1	0	0	0	0	1
Reindeer	0	0	0	0	2	2
California sea lion	0	0	0	0	1	1
Place of worship	3	3	47	1	2	56
Town	8	2	0	6	0	16
Album cover	0	0	0	3	0	3
Personal protective equipment	1	0	0	2	1	4
Equestrianism	3	0	0	3	0	6
Close-up	0	0	3	0	3	6
Concrete	0	0	0	0	2	2
Abseiling	0	0	0	0	1	1
Trophy	0	0	0	0	22	22
Water feature	0	0	0	0	29	29
Flip (acrobatic)	0	0	0	0	3	3
Plant stem	3	1	0	0	1	5
Vestment	0	0	11	0	0	11
Astronaut	0	0	1	0	0	1
Crucifix	0	0	4	0	2	6
Globe	0	0	0	0	2	2
Watercraft	19	32	0	26	0	77
Headstone	0	0	0	0	2	2
Automotive wheel system	0	0	0	0	4	4
Pack animal	2	0	0	0	0	2
Pointer	2	0	0	0	1	3
Makeup mirror	0	0	0	2	0	2
Electric blue	0	0	0	1	1	2
Waterfall	0	0	0	4	0	4
Domestic pig	0	0	0	0	1	1
Fictional character	219	168	62	138	125	712
Aquarium decor	0	0	0	0	3	3
Wetland	0	1	0	2	0	3
Superhero	1	0	0	0	0	1
Daydream	0	0	0	2	0	2
Rodent	1	0	0	0	0	1
Tabby cat	0	2	0	0	0	2
Tugboat	0	1	0	0	0	1
Organism	37	45	4	3	39	128
Brass instrument	0	0	0	0	5	5
Floral design	1	0	0	0	0	1
National historic landmark	0	0	0	0	44	44
Duck	3	1	0	0	0	4
Rug	0	0	4	0	0	4
Plane	0	0	0	1	0	1
Heart	0	0	0	0	1	1
Overhead power line	0	0	0	0	1	1
Icon	0	1	1151	2	0	1154
Perennial plant	2	0	0	0	4	6
Wood	7	4	62	1	76	150
Woodland	1	8	0	5	1	15
Desert	0	0	0	0	1	1
Lymnaeidae	0	1	0	0	0	1
Mammal	2	0	0	3	4	9
Domestic rabbit	0	0	0	0	2	2
Coal	1	0	0	0	0	1
Needlework	0	0	8	0	0	8
Steam frigate	3	1	0	0	0	4
Plantation	0	1	0	0	0	1
State park	0	0	0	1	0	1
Longhaired whippet	0	0	0	1	0	1
Cowboy	3	1	0	0	0	4
Combat	0	0	0	1	0	1
Human body	9	0	0	0	18	27
Pine family	2	2	0	0	0	4
Hair accessory	2	0	0	10	2	14
Paper	44	19	13	3	1	80
Penguin	1	0	0	0	1	2
Dog	8	1	0	3	5	17
Gunboat	2	0	0	0	0	2
Tortoise	1	2	0	0	1	4
Clay	0	0	0	0	9	9
Guitar	1	0	0	0	0	1
Common snapping turtle	0	1	0	0	0	1
Water	9	16	0	15	34	74
Retro style	5	4	1	0	0	10
Rainbow	0	0	0	3	0	3
Viol	0	0	0	1	0	1
Curtain	2	0	0	0	0	2
Puppy	1	0	0	0	0	1
Silver	1	0	3	0	6	10
Map	1	3	0	0	0	4
Electrical supply	0	0	0	0	1	1
Garden roses	7	0	0	0	0	7
Geomungo	1	0	0	0	0	1
Shipwreck	0	0	0	1	0	1
Italian greyhound	0	0	0	0	1	1
Barn	0	0	0	1	0	1
Grazing	0	0	0	1	0	1
Tiger	0	1	0	0	0	1
Tooth	0	0	0	0	1	1
Road	1	0	0	0	0	1
Canoe	2	0	0	0	0	2
Crane-like bird	0	1	0	0	0	1
Peony	1	0	0	0	0	1
Soldier	2	0	0	0	1	3
Mansion	0	0	0	2	2	4
Vernissage	0	0	1	0	0	1
Lip	2	0	1	2	2	7
Fence	0	1	0	0	0	1
Log cabin	2	0	0	2	0	4
Ballet dancer	3	0	0	1	3	7
Crew	0	1	0	0	0	1
Wicker	0	0	0	0	1	1
Ink	1	6	0	0	0	7
Junk food	0	0	0	1	0	1
Tuxedo	0	0	0	7	0	7
Conifer	0	1	0	0	0	1
Altar	0	0	11	1	0	12
Fog	0	0	0	1	0	1
Airline	0	0	0	1	0	1
Sporting Group	3	1	1	1	3	9
Sailboat	0	5	0	8	0	13
Cobalt blue	0	0	0	0	1	1
Pedestal	0	0	0	0	3	3
White stork	0	1	0	0	0	1
Bengal tiger	0	0	0	0	1	1
Automotive tire	0	0	0	0	1	1
Floor	0	0	1	1	4	6
Pope	0	1	8	5	0	14
Forest	7	14	0	8	0	29
Windmill	1	1	0	0	0	2
Military person	0	0	0	1	0	1
Adaptation	19	27	2	7	19	74
Penteconter	0	1	0	0	0	1
Lighting	0	0	0	0	3	3
Western pleasure	1	0	0	0	0	1
Collection	4	6	90	4	5	109
Graphics	4	1	1	2	2	10
Organ	1	0	0	0	2	3
Computer accessory	0	0	1	1	0	2
Skeleton	0	0	0	0	13	13
Mane	5	0	0	0	5	10
Manila galleon	3	0	0	0	0	3
Cross-stitch	0	0	8	0	0	8
House	20	16	0	14	5	55
Highland	0	1	0	4	0	5
Carbonated soft drinks	1	0	0	0	0	1
Rope climbing	0	0	0	0	1	1
Dragon	0	0	0	0	6	6
Geological phenomenon	4	1	0	10	0	15
Art model	11	1	0	6	4	22
Pole	0	3	0	2	3	8
T-shirt	1	1	0	0	0	2
Longboard	1	0	0	0	0	1
Banknote	0	1	2	0	0	3
Felidae	4	5	0	0	27	36
Shield	1	0	0	0	0	1
Brown hair	1	0	0	2	1	4
Meal	3	0	0	0	0	3
White rhinoceros	0	0	0	0	2	2
Chambered nautilus	0	0	0	0	1	1
Reading	5	1	0	17	1	24
Electronic device	0	0	0	1	0	1
Atmospheric phenomenon	6	1	0	30	2	39
Playground slide	0	0	0	0	3	3
Lawn mower	0	0	0	0	1	1
Easel	2	0	1	0	0	3
World	3	3	0	1	18	25
Antique car	3	0	0	0	0	3
Carp	0	1	0	0	0	1
Songbird	1	0	0	0	0	1
Cash	0	0	10	0	0	10
Marsh	0	0	0	1	0	1
Basilica	4	2	3	2	0	11
Vertebrate	2	0	0	3	2	7
Physicist	1	2	0	0	0	3
Fiddle	0	0	0	1	1	2
Cart	5	2	0	3	1	11
Snails and slugs	0	0	0	0	1	1
Massif	0	1	0	0	0	1
Pottery	0	0	0	0	3	3
Claw	0	0	0	0	1	1
Fashion design	7	0	0	0	1	8
Fashion illustration	44	2	0	0	0	46
Triceratops	0	0	0	0	1	1
Musical ensemble	0	0	0	1	0	1
Tribe	1	0	0	0	0	1
Classic car	7	1	0	0	0	8
Cliff	4	6	0	10	0	20
Crochet	0	0	0	0	1	1
Hand	8	3	3	1	65	80
Chair	0	0	1	0	2	3
Saluki	0	0	0	1	0	1
Greyhound	1	0	0	0	0	1
Hand fan	1	0	0	2	0	3
Boat	22	29	0	31	0	82
Flooring	0	0	1	0	2	3
Hair	20	5	1	9	10	45
Tropical and subtropical coniferous forests	0	3	0	2	0	5
String instrument	1	0	0	2	1	4
Beaver	1	0	0	0	0	1
Plain	0	0	0	12	1	13
African elephant	1	0	0	0	4	5
American pit bull terrier	0	0	0	0	1	1
Bowed string instrument	0	0	0	2	1	3
Conservation-restoration	0	0	0	0	1	1
Troop	2	0	0	2	0	4
Dobermann	0	1	0	0	0	1
Peach	0	0	1	0	0	1
Worship	0	0	1	0	0	1
Sailing	0	6	0	5	0	11
Sidewalk	0	0	0	0	2	2
Atmosphere	0	1	0	15	2	18
Moscow watchdog	1	0	0	0	0	1
Red juniper	0	0	0	1	0	1
Coachman	3	1	0	1	0	5
Ship	8	11	0	12	0	31
Carrack	1	2	0	0	0	3
Bodybuilding	0	0	0	0	3	3
Clock tower	1	0	0	0	0	1
Dogue de bordeaux	0	1	0	0	0	1
Cottage	0	1	0	0	0	1
Shelving	0	0	0	0	1	1
Poster	10	10	68	2	1	91
Edible mushroom	1	0	0	0	0	1
Leisure	0	0	0	0	18	18
Pine	0	0	0	1	0	1
Land lot	1	0	0	1	3	5
Hot air balloon	0	1	0	0	0	1
Religious item	1	0	274	1	4	280
Family car	3	0	0	0	0	3
Hill station	0	0	0	1	0	1
Common bottlenose dolphin	0	0	0	0	1	1
Currency	0	0	5	0	0	5
Bird	10	12	0	2	8	32
Clock	1	1	0	0	0	2
Pier	1	0	0	3	0	4
Shimada	2	2	0	0	0	4
Walk-behind mower	0	0	0	0	1	1
Jumping	2	0	0	0	6	8
Purple	2	0	0	0	1	3
Deer	0	0	0	0	5	5
Gargoyle	0	0	0	0	7	7
Games	10	6	15	13	28	72
Macropodidae	0	1	0	0	1	2
Meadow	0	0	0	4	2	6
Ceramic	0	0	0	0	31	31
Bank	14	0	0	31	0	45
Elephant beetle	0	1	0	0	0	1
Alloy wheel	0	0	0	0	1	1
Glass	0	2	10	1	25	38
Kimono	0	1	0	0	0	1
Meditation	0	0	0	0	6	6
Colorado spruce	1	0	0	0	0	1
Sperm whale	1	0	0	0	0	1
Eagle	0	0	0	0	1	1
Horse trainer	2	3	0	102	11	118
Human settlement	4	1	0	1	1	7
Primate	0	0	0	0	3	3
Squash	0	0	0	0	1	1
Outerwear	8	1	5	20	10	44
Tradition	2	1	3	3	1	10
Money	0	0	11	0	0	11
oxcart	0	1	0	0	0	1
Petal	4	0	0	0	1	5
Black rhinoceros	0	1	0	0	3	4
Fashion accessory	1	1	16	16	8	42
Vintage clothing	7	5	0	3	0	15
Finger	0	1	3	1	14	19
Tower block	0	0	0	0	3	3
Performance	0	0	0	3	13	16
Violin family	0	0	0	2	1	3
Wildlife	14	7	1	6	31	59
Siberian tiger	0	1	0	0	0	1
Triumphal arch	4	3	0	0	0	7
Sword	1	0	0	0	0	1
Whooping crane	0	1	0	0	0	1
Bicycle wheel	0	0	0	0	1	1
Stencil	1	0	0	0	0	1
Forehead	90	10	49	20	86	255
Fiction	24	7	1	0	0	32
Brown	1	0	16	1	0	18
Promontory	0	0	0	3	0	3
Plastic	0	0	0	0	2	2
Rein	19	3	0	12	5	39
Paint	17	1	3	9	0	30
Raft	1	0	0	0	0	1
Parrot	1	0	0	0	0	1
Art paper	0	0	0	1	0	1
Garden	0	0	0	0	99	99
Sousaphone	0	0	0	0	1	1
Harbor	1	0	0	11	0	12
High heels	0	0	0	0	1	1
Farm	1	0	0	2	0	3
Reflection	3	2	0	3	8	16
Bag	0	1	0	0	0	1
Thoroughfare	4	0	0	0	0	4
Baby	0	0	0	4	0	4
Rebellion	2	1	0	4	0	7
Handwriting	2	0	0	0	0	2
Antique	9	12	511	83	8	623
Wallet	0	0	10	0	0	10
Outer space	0	0	0	0	1	1
Bridle	16	3	0	11	4	34
Mineral	0	0	0	0	3	3
Gentleman	30	5	3	263	0	301
Fire	0	0	0	0	1	1
Dust	0	0	0	2	0	2
Sculptor	0	0	0	0	208	208
Dress	6	1	0	119	7	133
Pattern	20	8	13	12	1	54
Serving tray	0	0	1	0	0	1
Trapeze	0	0	0	0	1	1
Steeple	3	3	0	0	0	6
Tree stump	1	0	0	0	1	2
Head	83	13	48	4	115	263
Laugh	0	0	0	0	1	1
Animation	3	0	1	4	13	21
Star	1	0	0	0	3	4
Zebra	0	0	0	0	1	1
Frock coat	0	0	0	1	0	1
Reptile	1	1	0	0	0	2
Butternut squash	0	0	0	0	1	1
Field	0	0	0	3	0	3
Prairie	0	0	0	5	0	5
Trumpeter	1	0	0	0	2	3
Ball	0	0	0	0	2	2
Autograph	2	0	0	0	0	2
Sport venue	1	0	0	0	1	2
Double bass	0	0	0	1	1	2
Unicorn	0	0	0	0	1	1
White-collar worker	1	0	0	0	0	1
Basketball	0	0	0	0	1	1
Tree house	1	0	0	0	0	1
Chainsaw carving	0	0	0	0	33	33
Stream	0	1	0	2	0	3
Flute	0	0	0	1	0	1
Team sport	1	0	0	1	1	3
Aircraft	1	0	0	1	1	3
Norwegian forest cat	1	0	0	0	0	1
Agave azul	0	0	0	0	1	1
Metropolis	2	0	0	0	3	5
Wallpaper	1	0	0	0	0	1
Black	0	3	0	4	4	11
Stairs	0	0	0	0	1	1
Snapshot	4	6	0	0	1	11
Quilt	0	0	2	1	0	3
Pavilion	0	0	0	0	2	2
Steppe	0	0	0	8	0	8
Zen master	0	0	0	1	0	1
Black-and-white	170	125	0	2	73	370
Hunting	0	0	0	1	0	1
Lectern	0	0	0	0	1	1
Plant community	0	0	0	3	2	5
Rain	1	0	0	0	0	1
Survey vessel	0	1	0	0	0	1
Sportswear	0	0	0	1	0	1
Sangharaja	0	0	0	2	0	2
Stone tool	0	0	0	1	0	1
Adventure game	0	0	0	4	0	4
Embroidery	0	0	8	0	0	8
Facial hair	33	12	84	24	3	156
Flowering plant	5	0	0	1	1	7
Text	36	17	26	1	0	80
Sleep	2	0	0	1	0	3
Winter	11	4	0	6	3	24
Side cap	0	0	0	1	0	1
Historic site	7	3	0	5	27	42
Landscape	50	36	0	125	33	244
Totem	0	0	0	0	2	2
Classic	11	1	0	2	0	14
Aviation	1	0	0	1	1	3
Mammoth	0	0	0	0	1	1
Nap	1	1	0	1	0	3
Cetacea	1	0	0	0	1	2
Swamp	1	2	0	1	0	4
Ocean	0	0	0	5	3	8
Medal	0	0	4	0	0	4
Landscaping	0	0	0	2	15	17
Flesh	0	0	1	4	1	6
Leather	0	0	6	0	0	6
Steamboat	0	3	0	0	0	3
Coral reef	0	0	0	0	1	1
Amphibian	1	1	0	0	0	2
Kung fu	0	0	0	1	1	2
Wall clock	1	0	0	0	0	1
Bird of prey	2	5	0	0	5	12
Facade	13	6	0	0	5	24
Spiral	0	1	0	0	2	3
Lady	59	7	9	1051	11	1137
Galley	2	2	0	0	0	4
Molding	3	0	0	0	0	3
Non-Sporting Group	0	1	0	0	3	4
Living room	1	0	0	2	0	3
Leaf	6	2	2	1	7	18
Coral	0	0	0	0	1	1
Gold	0	0	32	0	3	35
Blue	0	0	1	2	1	4
Health care provider	0	0	0	1	0	1
Village	1	1	0	17	0	19
Firearm	0	0	0	0	1	1
Brick	0	0	0	0	1	1
Aqua	0	0	0	0	1	1
Peregrine falcon	0	1	0	0	0	1
Clergy	0	0	5	0	0	5
Opera	0	0	0	1	0	1
Tea party	1	0	0	0	0	1
Water resources	2	0	0	1	2	5
Animal figure	1	0	0	0	69	70
Vascular plant	2	2	0	0	0	4
Natural arch	0	0	0	0	1	1
Agave	0	0	0	0	1	1
Cushion	0	0	1	0	0	1
Hairstyle	21	7	0	16	8	52
Russell terrier	1	0	0	0	0	1
Chin	73	5	12	24	54	168
Rope	0	0	0	0	1	1
Reef	0	0	0	0	1	1
Abbess	0	0	13	4	0	17
Fluyt	2	2	0	0	0	4
Military organization	2	0	0	0	0	2
Almshouse	5	14	0	0	0	19
Longship	0	1	0	0	0	1
Moon	0	0	0	1	0	1
Steam engine	0	1	0	0	0	1
Vegetable	1	0	0	0	1	2
Flagship	3	0	0	1	0	4
Polish greyhound	1	0	0	0	0	1
Cello	0	0	0	1	1	2
Kneeling	3	1	0	0	9	13
Birch	0	1	0	0	0	1
Tavern	0	0	0	2	0	2
Caravel	2	5	0	0	0	7
Shoemaking	1	0	0	0	0	1
Knee	2	0	0	0	2	4
Mustang horse	0	0	0	0	5	5
Cuirass	1	0	0	0	0	1
Fruit	1	0	0	1	0	2
Public space	1	0	0	0	8	9
Circus	0	0	0	0	2	2
Art gallery	0	0	6	0	9	15
Souvenir	0	0	2	0	0	2
Soil	0	0	0	0	4	4
Great dane	0	1	0	0	1	2
Geisha	2	3	1	2	0	8
Lavender	2	0	0	1	0	3
Ivory	0	0	0	0	3	3
Pear	0	0	0	0	1	1
Horse racing	5	0	0	1	0	6
Botanical garden	0	0	0	0	28	28
Terrapin	0	1	0	0	0	1
Airliner	0	0	0	1	0	1
Stone carving	3	3	147	0	761	914
Dogo argentino	0	0	0	0	1	1
Shadow	1	0	0	0	2	3
Human leg	1	0	0	0	1	2
Egyptian temple	1	0	0	0	1	2
Turquoise	1	0	2	0	12	15
Ancient roman architecture	4	2	0	0	0	6
Tundra	0	0	0	1	0	1
Postage stamp	1	0	4	0	0	5
Clip art	10	3	0	0	0	13
Pulpit	0	0	0	0	1	1
Wall	6	1	1	0	5	13
Cold weapon	1	0	0	0	0	1
Classical sculpture	3	1	0	0	928	932
Goats	2	0	0	0	1	3
Lawn ornament	0	0	0	0	158	158
Monarch	2	0	18	80	0	100
Shore	2	0	0	6	0	8
Musical instrument	2	1	0	6	1	10
Cylinder	0	0	0	1	0	1
Christmas	0	0	1	0	0	1
Limestone	0	0	0	0	1	1
Brickwork	0	0	0	0	1	1
Gondola	3	4	0	4	1	12
Fur	3	0	0	1	0	4
Channel	1	0	0	0	0	1
Stitch	0	0	1	0	0	1
Wrinkle	0	2	1	0	4	7
Crypt	1	1	0	0	0	2
Snow	8	3	0	4	1	16
Pilgrims	8	0	0	26	0	34
Port	1	0	0	7	0	8
Fetish model	1	0	0	0	0	1
Wedding dress	0	0	0	1	0	1
Airplane	1	0	0	1	1	3
Smile	5	1	5	63	4	78
Mosaic	0	0	87	2	1	90
Fish	1	1	0	0	2	4
Hot rod	1	0	0	0	0	1
Grass	1	4	0	9	202	216
Old-growth forest	1	6	0	4	0	11
Jungle	0	0	0	1	0	1
Rhinoceros	0	1	0	0	4	5
Bowhead	1	0	0	0	0	1
Arm	24	4	0	0	43	71
Folk dance	1	0	0	2	0	3
Table	11	2	0	1	17	31
Fashion	6	1	0	111	2	120
Creative arts	0	0	1	0	0	1
Portrait	237	29	446	1539	12	2263
Perching bird	1	0	0	1	0	2
Belt	0	0	1	0	0	1
Floribunda	1	0	0	0	0	1
Butterfly	0	0	0	0	1	1
Arch	17	21	16	2	7	63
Suitcase	0	0	0	0	1	1
Conversation	1	0	0	1	0	2
Gold medal	0	0	1	0	0	1
Frigate	6	7	0	8	0	21
Northern hardwood forest	1	2	0	6	0	9
Hindu temple	2	1	0	0	0	3
Western riding	0	0	0	4	0	4
Physical fitness	0	0	0	0	1	1
Sculpture	4	1	32	7	1806	1850
Glasses	0	0	0	1	0	1
Still life photography	33	11	3	6	29	82
Ciconiiformes	0	1	0	0	0	1
Naval trawler	1	0	0	0	0	1
Condominium	0	0	0	0	1	1
Nepenthes	0	0	0	0	1	1
Beige	3	0	0	3	4	10
Antler	0	0	0	0	4	4
Sorrel	1	0	0	0	3	4
Napoleon iii style	0	0	1	0	0	1
Dagger	1	0	0	0	0	1
Plumbing fixture	0	0	0	0	1	1
Water transportation	2	2	0	3	0	7
Porcelain	1	0	0	5	3	9
Extinction	1	0	0	0	3	4
Bard	1	0	0	0	0	1
Owl	1	5	0	0	5	11
Viaduct	0	5	0	0	0	5
Photographic paper	0	1	0	0	0	1
Bass violin	0	0	0	1	0	1
Boating	1	5	0	0	0	6
Alcohol	0	0	0	1	0	1
Wing chun	1	0	0	0	0	1
Oval	1	2	1	64	0	68
Holiday	0	0	1	1	0	2
Street performance	0	0	0	0	1	1
Sea turtle	0	1	0	0	0	1
Pachycephalosaurus	1	0	0	0	0	1
British longhair	1	0	0	0	0	1
Leg	18	1	0	1	28	48
Ironclad warship	2	2	0	0	0	4
Ground beetle	0	1	0	0	0	1
Muroidea	1	0	0	0	0	1
Tattoo	1	0	2	0	0	3
Bronze sculpture	0	0	11	0	490	501
Rock	8	14	2	14	112	150
Publication	1	0	0	0	0	1
Urban area	1	0	0	0	3	4
Saddle	2	0	0	2	0	4
Lance	1	0	0	0	0	1
Reining	1	0	0	2	0	3
Outdoor furniture	0	0	0	0	3	3
Dreadnought	0	1	0	0	0	1
Ridge	0	0	0	1	0	1
Boats and boating--Equipment and supplies	2	0	0	0	0	2
Army men	2	0	0	0	0	2
Plucked string instruments	1	0	0	2	0	3
Kangaroo	0	1	0	0	2	3
Cope	0	0	16	1	0	17
Badlands	0	0	0	0	1	1
Robe	0	0	0	3	1	4
Stallion	3	1	0	7	25	36
Whiskers	1	3	0	0	0	4
Choir	0	0	0	1	0	1
Armour	3	1	0	6	0	10
Woodwind instrument	0	0	0	1	0	1
Tulip	0	2	0	0	0	2
Formation	0	1	0	0	5	6
Ammonoidea	0	0	0	0	1	1
Christmas ornament	0	0	1	0	0	1
Mountain range	0	2	0	1	0	3
Inflatable	0	0	0	0	9	9
Bookmark	0	0	1	0	0	1
Viking ships	0	2	0	0	0	2
Font	16	14	11	8	8	57
Military uniform	1	0	0	1	0	2
Residential area	1	0	0	0	0	1
Mountain	0	4	0	5	0	9
Ceiling	3	0	1	6	0	10
Baseball	1	0	0	0	0	1
Coupé	1	0	0	0	0	1
Horse harness	4	1	0	1	1	7
Ornament	0	0	2	2	4	8
Dolphin	1	0	0	0	3	4
Interior design	16	3	10	10	14	53
Bamboo	0	0	0	0	1	1
Daytime	0	0	0	2	0	2
Design	8	1	1	2	8	20
Viking	5	0	1	0	0	6
Downtown	1	0	0	0	1	2
Fun	2	0	0	0	2	4
Orange	0	0	0	1	2	3
Spider	0	0	0	0	2	2
Religious institute	0	0	14	1	0	15
Canidae	12	4	0	9	15	40
Indoor games and sports	0	0	0	0	1	1
Acrylic paint	12	0	7	44	0	63
Molosser	1	0	0	0	0	1
Rabbits and Hares	1	0	0	0	3	4
Street fashion	0	0	0	0	1	1
York boat	1	0	0	0	0	1
Sloop	0	1	0	0	0	1
Galleon	4	5	0	4	0	13
Athletics	0	0	0	0	2	2
Wire	0	0	0	1	1	2
Track and field athletics	0	0	0	0	2	2
Gown	1	0	0	107	0	108
Grassland	0	0	0	8	3	11
Military aircraft	1	0	0	0	0	1
Hut	3	3	0	1	0	7
Igneous rock	0	0	0	0	1	1
Nonbuilding structure	2	3	0	0	613	618
hoopskirt	1	0	0	99	0	100
Crown	0	1	0	2	0	3
Amusement ride	0	0	0	0	2	2
Headquarters	0	0	0	0	3	3
Automotive design	1	0	0	0	0	1
Cg artwork	12	2	0	21	4	39
Q-ship	2	1	0	0	0	3
Branch	18	20	0	0	14	52
Human	48	10	9	11	64	142
Guitarist	1	0	0	0	0	1
Indian elephant	1	1	1	1	4	8
Iceberg	0	0	0	0	2	2
Doodle	9	1	0	0	0	10
Shepherd	0	1	0	0	0	1
Line art	116	43	0	0	2	161
Spruce-fir forest	0	1	0	2	0	3
Cat	1	4	0	0	5	10
Military officer	0	0	0	4	0	4
Courthouse	1	0	0	0	0	1
Egg	0	0	0	0	2	2
Costume	7	1	0	8	1	17
Face	62	9	7	3	24	105
Hard hat	0	0	0	0	1	1
European shorthair	0	1	0	0	0	1
Arachnid	0	0	0	0	2	2
River	13	3	0	15	0	31
Home accessories	0	0	3	0	0	3
Blue whale	1	0	0	0	0	1
Watercourse	2	0	0	7	0	9
Rabbi	0	0	1	2	0	3
Heron	0	1	0	0	0	1
Gusli	0	0	0	1	0	1
Architecture	93	68	38	32	182	413
Crowd	2	0	0	13	0	15
Antenna	0	0	0	0	1	1
Blister beetles	0	1	0	0	0	1
Octopus	0	0	0	0	3	3
Finial	0	0	0	0	3	3
Mortar	0	0	0	0	1	1
Lawn	0	0	0	0	41	41
Crane	0	1	0	0	0	1
Angel	0	1	9	2	24	36
Serveware	3	0	1	0	0	4
Streetball	0	0	0	0	1	1
Denim	0	0	0	1	0	1
Sled dog	0	0	0	1	0	1
Pc game	0	0	0	1	1	2
Bead	0	0	1	0	0	1
Rain chain	0	0	0	0	2	2
Borzoi	1	0	0	0	0	1
Illustration	787	703	320	214	33	2057
Santoor	0	0	0	1	0	1
Bench	0	0	0	0	3	3
Book cover	0	1	0	0	0	1
Stag beetles	0	1	0	0	0	1
Cartoon	93	52	0	2	0	147
Armored car	0	1	0	0	0	1
Feather	0	0	0	0	2	2
Boar	0	0	0	0	2	2
Street art	6	0	0	3	1	10
Woody plant	11	10	0	7	9	37
Cow-goat family	1	1	0	0	2	4
Falconiformes	0	4	0	0	0	4
General aviation	0	0	0	0	1	1
Liver	1	0	0	0	1	2
Plywood	0	0	0	0	1	1
Cycling	1	0	0	0	1	2
Modern dance	0	0	0	1	2	3
Bayou	3	3	0	5	0	11
Peafowl	0	0	0	0	1	1
Abdomen	0	0	0	0	1	1
Savanna	1	0	0	4	1	6
Turtle	1	1	0	0	0	2
Trumpet	0	0	0	0	2	2
Canal	14	5	0	13	0	32
Discus throw	0	0	0	0	9	9
Hieromonk	0	0	4	6	0	10
Column	5	2	0	0	2	9
Hedgehog	1	0	0	0	0	1
Kilt	1	1	0	0	0	2
Coffee table	0	0	0	0	1	1
Ritual	1	1	6	0	0	8
Arch bridge	1	1	0	0	0	2
Umbrella	0	0	0	1	0	1
Acrobatics	0	0	0	0	5	5
Devil's bridge	1	0	0	0	0	1
Graphic design	4	2	1	5	2	14
Kitten	1	1	0	0	0	2
Massively multiplayer online role-playing game	0	0	0	1	1	2
Batholith	0	1	0	0	0	1
Adventure	1	0	0	0	1	2
Dinosaur	1	0	0	1	6	8
Battle	5	5	0	11	0	21
Costume design	47	10	0	115	1	173
Barn owl	0	1	0	0	1	2
Great horned owl	0	1	0	0	0	1
White pine	1	0	0	0	0	1
Mixed-use	1	0	0	0	0	1
Snout	2	0	0	0	22	24
Suit	1	0	0	7	0	8
Nature reserve	0	1	0	7	1	9
Action-adventure game	0	0	0	1	0	1
Grizzly bear	1	0	0	0	2	3
True frog	0	1	0	0	0	1
Terrestrial animal	1	0	0	0	24	25
Puppy love	2	0	0	0	0	2
Wagon	4	0	0	1	0	5
Mirror	0	0	3	10	0	13
Klippe	0	1	0	3	0	4
Bouquet	9	0	0	0	0	9
Nose	57	6	12	1	15	91
Pebble	0	0	0	0	1	1
Chariot racing	0	0	0	1	0	1
Twig	5	0	0	0	7	12
Bald eagle	0	0	0	0	1	1
Working animal	9	4	0	1	5	19
Christmas tree	2	0	0	0	0	2
Jack russell terrier	1	0	0	0	0	1
Automotive lighting	1	0	0	0	0	1
Flag	0	0	1	0	0	1
Villa	0	0	0	0	1	1
Sail	2	5	0	6	0	13
Domestic short-haired cat	0	1	0	0	0	1
Jewellery	0	0	4	6	1	11
St. bernard	1	0	0	0	0	1
Child model	2	0	0	0	0	2
Weights	0	0	0	0	1	1
Red	1	0	5	4	2	12
Dancer	1	0	0	1	6	8
Aisle	1	1	0	0	0	2
Play	1	0	0	1	3	5
Convoy rescue ship	0	2	0	0	0	2
Photography	88	70	4	257	75	494
Street light	1	0	0	0	1	2
Burro	0	3	0	2	0	5
Rose family	4	0	0	0	1	5
Silken windhound	0	0	0	1	0	1
Watercraft rowing	1	1	0	1	0	3
Suidae	0	0	0	0	1	1
Model aircraft	0	0	0	1	0	1
Box	0	0	5	0	0	5
Tower	2	3	0	0	5	10
Middle ages	18	40	284	43	1	386
Chapel	6	4	5	1	0	16
Canoe birch	2	0	0	1	0	3
Interaction	0	0	1	1	0	2
Animated cartoon	4	0	0	0	0	4
Strategy video game	3	1	0	7	1	12
Mast	1	1	0	0	0	2
Infantry	2	0	0	1	0	3
Non-commissioned officer	0	0	0	1	0	1
Room	32	9	5	20	9	75
Wave	0	0	0	8	0	8
Brown bear	1	0	0	0	3	4
Artist	7	0	2	244	1	254
Headland	1	1	0	6	0	8
Terrain	6	13	0	10	2	31
Battleship	1	0	0	0	0	1
Cowboy hat	0	1	0	0	0	1
Lupin	0	0	0	1	0	1
Material property	0	0	0	0	1	1
Eastern Screech owl	0	1	0	0	0	1
Cumulus	0	0	0	4	0	4
Winter storm	10	0	0	4	0	14
Goose	0	0	0	0	1	1
Writing	2	0	0	0	0	2
Pendant	0	0	6	10	0	16
Coastal and oceanic landforms	0	1	0	4	0	5
Musician	2	0	0	3	0	5
Barechested	1	0	0	0	3	4
Guard dog	0	0	0	1	0	1
Hutch	1	0	0	0	0	1
Frog	0	1	0	0	0	1
Marine mammal	3	0	0	0	3	6
Parish	1	3	0	0	0	4
Supervillain	0	0	0	0	1	1
Performing arts	0	0	0	2	10	12
Carnivore	12	2	0	2	13	29
Beauty	3	0	0	2	4	9
Sea ice	0	0	0	0	1	1
Horizon	1	0	0	19	0	20
Pink	4	0	1	0	3	8
Pasture	0	0	0	5	1	6
Plush	0	0	0	0	1	1
Wind instrument	1	0	0	1	1	3
Box turtle	0	1	0	0	0	1
Horse tack	5	1	0	2	1	9
Conquistador	27	28	2	130	2	189
Companion dog	3	0	0	0	0	3
Duel	1	0	0	2	0	3
Medieval architecture	18	27	0	8	0	53
Tree	97	134	2	47	258	538
Archaeological site	0	0	2	0	2	4
Cityscape	6	0	0	5	0	11
Hardwood	0	0	0	0	3	3
First-rate	3	0	0	1	0	4
Anime	5	1	0	0	3	9
Psychedelic art	0	0	0	3	0	3
Falcon	0	1	0	0	0	1
Pankration	1	0	0	0	0	1
Lamp	0	0	0	0	5	5
Tapestry	16	30	200	24	0	270
Roman temple	2	0	0	0	0	2
Wetsuit	0	0	0	1	0	1
Land vehicle	2	0	0	0	0	2
Skateboard	1	0	0	0	0	1
Gun	0	1	0	0	1	2
Giraffidae	0	0	0	0	4	4
Orchestra	0	0	0	1	0	1
Label	1	0	2	2	0	5
Arthropod	0	1	0	0	1	2
Monochrome	60	48	0	0	10	118
Demon	2	1	0	0	0	3
Suspension bridge	1	1	0	0	0	2
Erinaceidae	1	0	0	0	0	1
Traditional sport	1	2	0	0	0	3
Tartane	0	1	0	0	0	1
Waterway	19	13	0	31	2	65
Granite	0	0	0	0	4	4
Nurse	0	0	0	1	0	1
Furniture	23	5	36	17	23	104
Cupid	3	0	0	5	5	13
Spear	0	1	0	0	0	1
Food	1	0	0	2	0	3
People	12	2	0	5	0	19
Calligraphy	1	1	1	1	0	4
Mill	0	1	0	0	0	1
Drinkware	2	2	0	0	0	4
Notebook	1	0	2	0	0	3
Iron	1	1	0	0	8	10
Plant pathology	1	0	0	0	0	1
Glacial landform	0	1	0	0	0	1
lilac	1	0	0	0	0	1
Accipitriformes	0	0	0	0	1	1
Cossacks	4	1	0	1	0	6
Sleeve	0	0	0	1	1	2
Watercolor paint	107	12	16	103	0	238
Holiday ornament	0	0	0	0	1	1
3d modeling	0	0	0	0	9	9
Coin	0	0	1	2	0	3
White	8	0	0	1	10	19
Love	1	0	1	0	1	3
Clothing	1	0	0	3	1	5
Estate	2	0	0	5	2	9
Collie	1	0	0	0	0	1
Beard	18	7	37	24	1	87
Motor vehicle	6	0	0	0	0	6
Invertebrate	0	1	0	0	2	3
Fortification	0	0	0	0	1	1
Pug	0	0	0	1	1	2
Shelf	0	0	0	0	3	3
Neck	6	0	2	5	15	28
Whippet	1	0	0	0	1	2
Skin	0	0	2	0	10	12
Plate	2	0	0	19	0	21
Wind wave	0	0	0	3	0	3
Arcade	5	5	0	0	0	10
Chest	5	4	0	2	9	20
Playground	0	0	0	0	3	3
Monolith	0	0	0	0	4	4
Dome	1	0	0	0	1	2
Flightless bird	1	0	0	0	2	3
Travel	0	0	0	0	1	1
Child	27	1	2	162	1	193
Sitting	52	13	2	43	54	164
Gesture	12	3	0	3	15	33
Camel	1	0	0	0	0	1
Historian	2	1	0	11	0	14
Pest	0	1	0	0	0	1
Sky	15	6	0	104	92	217
Flower Arranging	3	0	0	0	0	3
Tray	1	0	1	0	0	2
Cupboard	0	0	1	0	0	1
Facial expression	3	0	0	0	3	6
Stage	0	0	0	1	0	1
Silhouette	4	0	0	0	0	4
Eyebrow	31	5	0	96	2	134
Toad	1	0	0	0	0	1
Fawn	1	0	0	0	3	4
CD	0	0	1	0	0	1
Tourist attraction	1	0	12	9	35	57
Pole vault	0	0	0	0	1	1
Horse	24	12	0	114	44	194
Warship	2	1	0	0	0	3
Loch	0	0	0	4	0	4
Home	5	1	0	5	1	12
Sunrise	0	0	0	3	0	3
Alps	0	1	0	0	0	1
Glass bottle	0	0	0	1	0	1
Geology	0	2	0	3	7	12
Property	1	0	0	1	5	7
Comb over	0	0	0	1	0	1
Dusk	0	0	0	1	0	1
Flame	0	0	0	0	2	2
Botany	32	33	0	0	111	176
Belt buckle	0	0	2	0	0	2
Walking	1	0	0	0	0	1
Spire	1	3	0	0	0	4
Nativity scene	2	1	14	6	7	30
Anthropology	1	0	0	0	8	9
Pedestrian	0	0	0	1	0	1
Steel	0	0	0	0	1	1
Wing	2	2	0	2	24	30
Artifact	0	0	59	1	32	92
Freezing	0	0	0	0	2	2
Textile	19	33	144	26	0	222
Rural area	5	0	0	11	0	16
Art	966	713	2237	1967	1766	7649
Sandal	0	0	0	0	1	1
Elbow	0	0	0	0	1	1
Photograph	24	23	3	5	2	57
Ballet	0	0	0	1	1	2
Tribal chief	0	1	0	0	0	1
Romance	1	0	0	0	0	1
Ancient history	8	7	59	1	11	86
Long hair	22	0	0	7	6	35
Hen-of-the-wood	0	0	0	0	1	1
Ice skating	0	0	0	1	0	1
Sea otter	0	0	0	1	0	1
Demolition	0	0	0	0	1	1
American larch	1	0	0	0	0	1
Paper product	35	23	6	1	0	65
Teal	0	0	0	0	3	3
Pond	0	0	0	4	2	6
Irish wolfhound	1	0	0	0	0	1
Costume hat	0	1	0	0	0	1
Mission	0	1	0	0	0	1
Alley	1	0	0	0	0	1
Bridge	7	6	0	0	0	13
Wat	0	0	1	0	0	1
Vintage advertisement	1	1	0	0	0	2
Begging	0	0	0	0	1	1
Supernatural creature	2	2	7	2	4	17
Motif	1	0	0	1	0	2
Helmet	0	0	0	0	1	1
Cemetery	0	0	0	0	1	1
Samurai	1	1	0	0	0	2
Marble	0	0	1	0	47	48
Scene	0	0	0	2	0	2
Mountainous landforms	0	2	0	1	0	3
Mythology	75	177	54	322	65	693
Patriarch	0	0	19	3	0	22
Painting	413	287	1462	1952	3	4117
Wheel	0	0	0	0	5	5
Propeller-driven aircraft	1	0	0	0	0	1
Book	1	0	0	0	0	1
Portrait photography	0	0	0	2	0	2
Pre-dreadnought battleship	1	1	0	0	0	2
Riding instructor	1	0	0	0	0	1
