label	drawings	engraving	iconography	painting	sculpture	total
Indian rhinoceros	0	1	0	0	1	2
Château	2	2	0	0	0	4
East indiaman	1	3	0	6	0	10
Armored cruiser	0	1	0	0	0	1
Naval ship	0	1	0	0	0	1
Horse trainer	0	0	0	102	6	108
Hut	0	0	0	1	0	1
Human settlement	1	1	0	1	0	3
Wilderness	0	0	0	2	0	2
Figure drawing	51	7	0	1	1	60
Nonbuilding structure	1	1	0	0	157	159
Style	0	4	1	9	1	15
Fir	0	0	0	1	0	1
Segway	0	0	0	0	1	1
Craft	0	0	1	0	0	1
hoopskirt	0	0	0	99	0	99
Tail	0	1	0	1	5	7
Primate	0	0	0	0	1	1
Crown	0	1	0	2	0	3
Night	0	0	0	3	1	4
Squash	0	0	0	0	1	1
Light fixture	0	0	0	0	1	1
Outerwear	2	1	4	20	4	31
Tradition	0	0	2	3	0	5
Headquarters	0	0	0	0	1	1
Guillotine	0	3	0	0	0	3
Black cat	0	0	0	1	0	1
Destroyer	1	0	0	0	0	1
Rodeo	0	1	0	0	0	1
Cg artwork	0	1	0	21	1	23
Driftwood	0	0	0	0	5	5
Plaza	1	0	0	0	0	1
Q-ship	1	1	0	0	0	2
oxcart	0	1	0	0	0	1
Totem pole	0	0	0	0	1	1
People in nature	0	0	0	1	0	1
Branch	1	1	0	0	5	7
Black rhinoceros	0	1	0	0	1	2
Fashion accessory	0	1	1	16	2	20
Konghou	0	0	0	2	0	2
Blizzard	1	0	0	3	0	4
Hare	0	1	0	0	2	3
Vintage clothing	2	4	0	3	0	9
Human	6	6	1	11	17	41
Finger	0	0	0	1	0	1
Natural landscape	3	1	0	45	2	51
Indian elephant	0	0	0	1	2	3
Building	18	36	1	48	4	107
Classical architecture	1	9	0	0	2	12
Plaster	0	0	0	0	3	3
Performance	0	0	0	3	2	5
Violin family	0	0	0	2	0	2
Flower	1	0	2	7	3	13
Doodle	0	1	0	0	0	1
Wildlife	0	1	0	6	7	14
Ruffed grouse	0	1	0	0	0	1
Triumphal arch	1	0	0	0	0	1
Piano	0	0	0	1	0	1
Bin bag	0	0	0	0	1	1
Mouth	0	0	0	0	1	1
Shepherd	0	1	0	0	0	1
Wine bottle	0	0	0	1	0	1
Forehead	24	6	18	20	26	94
Relief	0	2	13	0	11	26
Hortaya borzaya	1	0	0	1	0	2
Line art	6	14	0	0	1	21
Spruce-fir forest	0	0	0	2	0	2
Fiction	0	3	0	0	0	3
Cat	0	1	0	0	2	3
Military officer	0	0	0	4	0	4
Harp	0	0	0	2	0	2
Giraffe	0	0	0	1	1	2
Brown	0	0	2	1	0	3
Promontory	0	0	0	3	0	3
Plastic	0	0	0	0	1	1
Rein	0	1	0	12	4	17
Bronze	0	0	2	4	110	116
Paint	2	0	0	9	0	11
Costume	0	0	0	8	0	8
Face	12	4	0	3	7	26
Eye	0	0	3	96	0	99
Knight	0	3	0	0	0	3
Art paper	0	0	0	1	0	1
River	9	2	0	15	0	26
Artwork	63	25	5	46	18	157
Garden	0	0	0	0	20	20
Clothes hanger	0	0	0	0	1	1
Drawing	114	101	2	113	9	339
Recreation	0	1	0	15	5	21
Street	1	3	0	0	0	4
Memorial	0	1	0	0	33	34
Harbor	0	0	0	11	0	11
Rabbi	0	0	1	2	0	3
Line	1	5	1	2	0	9
Transport	0	1	0	0	0	1
Watercourse	0	0	0	7	0	7
High heels	0	0	0	0	1	1
Farm	1	0	0	2	0	3
Palace	4	4	0	7	0	15
Gusli	0	0	0	1	0	1
Architecture	26	40	17	32	56	171
Art exhibition	0	0	1	0	0	1
Deacon	0	0	2	0	0	2
Reflection	1	0	0	3	2	6
Crystal	0	0	0	0	1	1
Crowd	1	0	0	13	0	14
Blessing	0	1	30	0	0	31
Blister beetles	0	1	0	0	0	1
Thoroughfare	1	0	0	0	0	1
Octopus	0	0	0	0	1	1
Baby	0	0	0	4	0	4
Finial	0	0	0	0	1	1
Rebellion	0	1	0	4	0	5
Coast	0	0	0	16	0	16
Space	0	0	0	3	1	4
Antique	0	8	24	83	5	120
Violin	0	0	0	1	0	1
Vehicle	3	35	0	65	4	107
Bridle	0	1	0	11	3	15
Mineral	0	0	0	0	2	2
Narcissus	0	0	1	0	0	1
Gentleman	17	4	2	263	0	286
Natural environment	0	1	0	26	1	28
Chariot	0	0	0	1	0	1
Elephant	0	0	0	1	3	4
Lawn	0	0	0	0	8	8
Dust	0	0	0	2	0	2
Angel	0	0	8	2	3	13
Sculptor	0	0	0	0	33	33
Candle holder	0	0	0	0	1	1
Dress	0	1	0	119	3	123
Cheek	1	0	7	122	6	136
Shot put	0	0	0	0	1	1
Bone	0	2	0	0	1	3
Bodybuilder	0	0	0	0	1	1
Pattern	0	3	7	12	1	23
Trapeze	0	0	0	0	1	1
Shoe	1	0	0	1	2	4
Toddler	0	0	0	10	0	10
Collage	0	0	0	1	1	2
Denim	0	0	0	1	0	1
Steeple	0	2	0	0	0	2
Horse and buggy	0	0	0	1	0	1
Lion	0	0	0	1	2	3
Mannequin	0	0	0	0	3	3
Head	16	8	13	4	37	78
Product	0	0	0	1	0	1
Sled dog	0	0	0	1	0	1
Official	0	0	0	1	0	1
Llama	0	0	0	0	1	1
Pc game	0	0	0	1	0	1
Animation	0	0	0	4	5	9
Plant	11	10	5	22	50	98
Bottle	0	0	0	1	0	1
Stock photography	18	94	49	29	8	198
Dish	0	0	0	1	0	1
Rain chain	0	0	0	0	1	1
Modern art	4	6	65	103	6	184
Illustration	70	212	158	214	10	664
Santoor	0	0	0	1	0	1
Black hair	0	0	0	6	0	6
Bench	0	0	0	0	1	1
Frock coat	0	0	0	1	0	1
Trunk	0	1	0	1	11	13
Hunting dog	1	0	0	0	0	1
Stag beetles	0	1	0	0	0	1
Book cover	0	1	0	0	0	1
Bansuri	0	0	1	0	0	1
Delphinium	0	0	0	1	0	1
Cartoon	0	12	0	2	0	14
Armored car	0	1	0	0	0	1
Reptile	0	1	0	0	0	1
Symmetry	0	1	0	0	0	1
Tide	0	0	0	4	0	4
Field	0	0	0	3	0	3
Prairie	0	0	0	5	0	5
Technology	0	0	0	1	4	5
Butternut squash	0	0	0	0	1	1
Feather	0	0	0	0	2	2
Boar	0	0	0	0	1	1
Street art	0	0	0	3	0	3
Woody plant	3	0	0	7	1	11
Morning	0	0	0	14	0	14
Beak	0	1	0	0	3	4
Cow-goat family	0	0	0	0	2	2
Liver	1	0	0	0	0	1
Horn	0	0	0	0	2	2
Male	2	0	0	6	4	12
Modern dance	0	0	0	1	0	1
Yellow	0	0	5	7	0	12
Carving	0	0	24	1	162	187
Bayou	2	0	0	5	0	7
Holy places	4	10	55	16	1	86
Convent	0	1	6	1	0	8
Evening	0	0	0	12	0	12
Underwater	0	0	0	0	1	1
Sport venue	0	0	0	0	1	1
Double bass	0	0	0	1	0	1
Peafowl	0	0	0	0	1	1
Cloud	1	0	0	24	5	30
Calm	1	0	0	20	0	21
Savanna	0	0	0	4	0	4
Turtle	0	1	0	0	0	1
Trumpet	0	0	0	0	1	1
Canal	11	1	0	13	0	25
Square	0	0	1	3	0	4
Discus throw	0	0	0	0	2	2
Formal wear	0	0	0	17	0	17
Hieromonk	0	0	4	6	0	10
Column	3	1	0	0	2	6
Marines	0	0	0	1	0	1
Family	1	0	0	3	0	4
Rabbit	0	1	0	0	0	1
earthenware	0	0	0	0	1	1
Chainsaw carving	0	0	0	0	6	6
Stream	0	0	0	2	0	2
Kilt	0	1	0	0	0	1
Sailing ship	0	2	0	4	0	6
Ritual	0	1	6	0	0	7
Arch bridge	1	0	0	0	0	1
Christmas eve	0	0	1	0	0	1
Umbrella	0	0	0	1	0	1
Screech owl	0	1	0	0	0	1
Flute	0	0	0	1	0	1
Ballet master	0	0	0	1	0	1
Team sport	0	0	0	1	0	1
Aircraft	0	0	0	1	0	1
Tall ship	0	0	0	3	0	3
Real estate	0	0	0	0	1	1
Devil's bridge	1	0	0	0	0	1
Graphic design	0	0	0	5	0	5
Black	0	0	0	4	3	7
Picture frame	2	17	170	200	0	389
Uniform	0	0	0	8	0	8
Snapshot	0	1	0	0	0	1
Quilt	0	0	1	1	0	2
Pavilion	0	0	0	0	2	2
Steppe	0	0	0	8	0	8
Dishware	0	0	0	7	0	7
Zen master	0	0	0	1	0	1
Schooner	0	2	0	4	0	6
Lilac	0	0	0	1	0	1
Vault	0	1	0	0	0	1
Fountain	0	0	0	0	2	2
Lady's maid	0	0	0	1	0	1
Attic	0	0	0	1	0	1
Moustache	0	3	13	4	0	20
Black-and-white	13	27	0	2	12	54
Massively multiplayer online role-playing game	0	0	0	1	0	1
Foot	1	0	0	0	0	1
Ruins	3	0	0	5	1	9
Synagogue	0	0	0	2	0	2
Batholith	0	1	0	0	0	1
Clipper	0	0	0	4	0	4
Adventure	0	0	0	0	1	1
Gothic architecture	0	1	0	0	0	1
Preacher	0	0	13	3	0	16
Coloring book	0	2	0	0	0	2
Green	1	0	1	4	3	9
Inlet	0	0	0	1	0	1
Coat	2	0	0	3	0	5
Clàrsach	0	0	0	2	0	2
Hunting	0	0	0	1	0	1
Plant community	0	0	0	3	0	3
Bull	0	0	0	0	2	2
heater	0	0	0	0	1	1
Circle	1	5	1	15	4	26
Still life	4	1	11	273	0	289
Dinosaur	0	0	0	1	3	4
Haute couture	0	0	0	1	0	1
Sportswear	0	0	0	1	0	1
Battle	0	5	0	11	0	16
Sangharaja	0	0	0	2	0	2
Adventure game	0	0	0	4	0	4
Stone tool	0	0	0	1	0	1
Embroidery	0	0	8	0	0	8
Facial hair	10	9	35	24	1	79
Flowering plant	0	0	0	1	0	1
Herd	0	0	0	3	0	3
Costume design	1	3	0	115	1	120
Text	1	12	8	1	0	22
Place of worship	0	3	13	1	0	17
Sleep	1	0	0	1	0	2
Winter	4	0	0	6	1	11
Town	4	2	0	6	0	12
Historic site	2	3	0	5	6	16
Great horned owl	0	1	0	0	0	1
Side cap	0	0	0	1	0	1
Quilting	0	0	0	1	0	1
Tololoche	0	0	0	2	0	2
Friar	0	0	2	0	0	2
Landscape	25	12	0	125	7	169
Album cover	0	0	0	3	0	3
Totem	0	0	0	0	1	1
Classic	1	1	0	2	0	4
Cross	0	0	1	0	0	1
Harvest	0	0	0	1	0	1
Aviation	0	0	0	1	0	1
Equestrianism	0	0	0	3	0	3
Personal protective equipment	0	0	0	2	0	2
Team	0	1	0	0	0	1
Nap	0	0	0	1	0	1
Close-up	0	0	3	0	0	3
Cetacea	0	0	0	0	1	1
Snout	0	0	0	0	4	4
Suit	0	0	0	7	0	7
Swamp	0	0	0	1	0	1
Ocean	0	0	0	5	1	6
Medal	0	0	1	0	0	1
Nature reserve	0	0	0	7	0	7
Pray	0	0	13	0	0	13
Flesh	0	0	1	4	0	5
Landscaping	0	0	0	2	4	6
Action-adventure game	0	0	0	1	0	1
Abseiling	0	0	0	0	1	1
Balance	0	0	0	0	2	2
Violone	0	0	0	2	0	2
True frog	0	1	0	0	0	1
Terrestrial animal	0	0	0	0	2	2
Menorah	0	0	0	0	1	1
Trophy	0	0	0	0	2	2
Sumatran rhinoceros	0	1	0	0	0	1
Wagon	0	0	0	1	0	1
Steamboat	0	1	0	0	0	1
Water feature	0	0	0	0	5	5
Plant stem	0	0	0	0	1	1
Eyewear	0	1	0	0	0	1
Vestment	0	0	8	0	0	8
Linens	0	0	0	1	0	1
Amphibian	0	1	0	0	0	1
Electricity	0	1	0	0	0	1
Mirror	0	0	0	10	0	10
Klippe	0	0	0	3	0	3
Hip	0	0	0	0	1	1
Coral reef	0	0	0	0	1	1
Kung fu	0	0	0	1	0	1
Foal	0	0	0	1	0	1
Sketch	111	41	0	3	2	157
Bird of prey	0	1	0	0	3	4
Facade	1	3	0	0	1	5
Nose	9	2	3	1	4	19
Lady	15	4	3	1051	3	1076
Galley	0	2	0	0	0	2
Lake district	0	0	0	2	0	2
Crucifix	0	0	2	0	0	2
Watercraft	2	22	0	26	0	50
City	11	14	0	37	3	65
Non-Sporting Group	0	0	0	0	2	2
Living room	0	0	0	2	0	2
Back	0	0	0	0	2	2
Sphere	0	0	0	0	5	5
Chariot racing	0	0	0	1	0	1
Leaf	1	1	1	1	2	6
Twig	0	0	0	0	5	5
Coral	0	0	0	0	1	1
Galiot	0	3	0	2	0	5
Lobby	0	1	0	0	0	1
Working animal	0	1	0	1	3	5
Automotive wheel system	0	0	0	0	1	1
Iris	2	0	0	14	0	16
Gold	0	0	1	0	1	2
Blue	0	0	0	2	0	2
Health care provider	0	0	0	1	0	1
Village	1	1	0	17	0	19
Pointer	1	0	0	0	1	2
Extreme sport	0	0	0	1	0	1
Earth	0	0	0	1	0	1
Makeup mirror	0	0	0	2	0	2
Musical	0	0	0	1	0	1
Electric blue	0	0	0	1	0	1
Ancient dog breeds	1	0	0	3	3	7
Warlord	0	0	0	0	1	1
Sail	0	3	0	6	0	9
Waterfall	0	0	0	4	0	4
Bed	0	0	0	2	0	2
Jewellery	0	0	2	6	0	8
Clergy	0	0	4	0	0	4
Fictional character	4	30	32	138	32	236
Aquarium decor	0	0	0	0	2	2
Volcanic field	0	0	0	1	0	1
Opera	0	0	0	1	0	1
Workhouse	0	1	0	0	0	1
Red	0	0	0	4	0	4
Wetland	0	0	0	2	0	2
Wild cat	0	1	0	0	0	1
Aisle	0	1	0	0	0	1
Water resources	1	0	0	1	0	2
Dancer	0	0	0	1	0	1
Play	0	0	0	1	0	1
Daydream	0	0	0	2	0	2
Convoy rescue ship	0	1	0	0	0	1
Photography	13	20	2	257	16	308
Tabby cat	0	1	0	0	0	1
Organism	2	7	1	3	9	22
Animal figure	0	0	0	0	23	23
Brass instrument	0	0	0	0	1	1
Street light	0	0	0	0	1	1
Hairstyle	6	2	0	16	1	25
Burro	0	1	0	2	0	3
Standing	7	0	0	6	34	47
Jeans	0	0	0	1	0	1
Chin	20	3	3	24	18	68
Silken windhound	0	0	0	1	0	1
Choreography	0	0	0	1	0	1
National historic landmark	0	0	0	0	10	10
Museum	0	0	1	0	12	13
Watercraft rowing	0	0	0	1	0	1
Easter egg	0	0	0	0	1	1
Rope	0	0	0	0	1	1
Ear	0	0	0	2	0	2
Reef	0	0	0	0	1	1
Printmaking	1	46	0	0	0	47
Footwear	2	0	0	2	2	6
Model aircraft	0	0	0	1	0	1
Abbess	0	0	10	4	0	14
Rug	0	0	1	0	0	1
Plane	0	0	0	1	0	1
Fluyt	1	1	0	0	0	2
Lake	0	0	0	4	0	4
Tower	1	2	0	0	0	3
Middle ages	2	15	121	43	1	182
Icon	0	1	439	2	0	442
Chapel	0	4	3	1	0	8
Perennial plant	0	0	0	0	2	2
Almshouse	1	10	0	0	0	11
Beetle	0	1	0	0	0	1
Wood	0	2	3	1	24	30
Longship	0	1	0	0	0	1
Woodland	0	1	0	5	1	7
Canoe birch	0	0	0	1	0	1
Hat	0	0	0	3	0	3
Platter	0	0	0	1	0	1
Bicycle	0	0	0	0	1	1
Interaction	0	0	1	1	0	2
Moon	0	0	0	1	0	1
Pastel	0	0	0	1	0	1
Strategy video game	0	1	0	7	0	8
Mare	1	0	0	1	1	3
Mast	0	1	0	0	0	1
Non-commissioned officer	0	0	0	1	0	1
Steam engine	0	1	0	0	0	1
Infantry	0	0	0	1	0	1
Construction paper	0	0	0	1	0	1
Mammal	0	0	0	3	2	5
Graffiti	0	0	0	4	0	4
Flagship	0	0	0	1	0	1
Vegetable	0	0	0	0	1	1
Victorian fashion	1	3	0	119	0	123
Polish greyhound	1	0	0	0	0	1
Needlework	0	0	8	0	0	8
Room	4	5	2	20	1	32
Nature	0	0	0	46	2	48
Wave	0	0	0	8	0	8
Cello	0	0	0	1	0	1
Brown bear	0	0	0	0	2	2
Pianist	1	0	0	3	0	4
Artist	1	0	1	244	0	246
Headland	0	0	0	6	0	6
Terrain	1	1	0	10	1	13
Kneeling	1	0	0	0	1	2
Cowboy hat	0	1	0	0	0	1
Bishop	0	0	3	0	0	3
Steam frigate	0	1	0	0	0	1
Lupin	0	0	0	1	0	1
Door	0	0	0	1	1	2
Violinist	0	0	0	1	0	1
Plantation	0	1	0	0	0	1
Haze	0	0	0	3	0	3
Eastern Screech owl	0	1	0	0	0	1
Cumulus	0	0	0	4	0	4
Jaw	31	4	0	9	15	59
Ceremony	0	0	4	1	0	5
Winter storm	2	0	0	4	0	6
Tavern	0	0	0	2	0	2
Caravel	0	2	0	0	0	2
Goose	0	0	0	0	1	1
High priest	0	0	69	7	0	76
Ox	0	0	0	0	1	1
Writing	2	0	0	0	0	2
Pendant	0	0	1	10	0	11
Yard	0	0	0	0	5	5
Bovine	0	0	0	2	2	4
Coastal and oceanic landforms	0	0	0	4	0	4
State park	0	0	0	1	0	1
Musician	0	0	0	3	0	3
Barechested	1	0	0	0	1	2
Longhaired whippet	0	0	0	1	0	1
Guard dog	0	0	0	1	0	1
Cowboy	0	1	0	0	0	1
Combat	0	0	0	1	0	1
Puzzle	0	0	1	0	0	1
Human body	3	0	0	0	6	9
Mustang horse	0	0	0	0	1	1
Frog	0	1	0	0	0	1
Muscle	7	0	0	2	21	30
Fruit	0	0	0	1	0	1
Parish	0	3	0	0	0	3
Hair accessory	0	0	0	10	1	11
Marine mammal	0	0	0	0	1	1
Public space	1	0	0	0	0	1
Performing arts	0	0	0	2	2	4
Carnivore	1	0	0	2	7	10
Paper	3	11	1	3	1	19
Beauty	0	0	0	2	0	2
Art gallery	0	0	2	0	2	4
Car	0	1	0	0	0	1
Dog	0	0	0	3	2	5
Tortoise	0	1	0	0	0	1
Horizon	0	0	0	19	0	19
Water bird	0	0	0	0	1	1
Small to medium-sized cats	0	1	0	0	1	2
Pasture	0	0	0	5	1	6
Clay	0	0	0	0	2	2
Common snapping turtle	0	1	0	0	0	1
Geisha	0	0	1	2	0	3
Lavender	0	0	0	1	0	1
Water	2	6	0	15	7	30
Retro style	0	3	1	0	0	4
Rainbow	0	0	0	3	0	3
Wind instrument	0	0	0	1	0	1
Plush	0	0	0	0	1	1
Box turtle	0	1	0	0	0	1
Ivory	0	0	0	0	2	2
Viol	0	0	0	1	0	1
Pear	0	0	0	0	1	1
Horse racing	0	0	0	1	0	1
Botanical garden	0	0	0	0	5	5
Terrapin	0	1	0	0	0	1
Horse tack	0	0	0	2	0	2
Stone carving	0	0	11	0	206	217
Map	0	2	0	0	0	2
Airliner	0	0	0	1	0	1
Silver	0	0	0	0	2	2
Toy	0	0	0	96	13	109
Shadow	0	0	0	0	2	2
Shipwreck	0	0	0	1	0	1
Geomungo	1	0	0	0	0	1
Turquoise	0	0	1	0	1	2
Conquistador	0	7	2	130	1	140
Ancient roman architecture	1	2	0	0	0	3
Storm	0	0	0	5	0	5
Duel	0	0	0	2	0	2
Tundra	0	0	0	1	0	1
Barn	0	0	0	1	0	1
Grazing	0	0	0	1	0	1
Medieval architecture	4	21	0	8	0	33
Tree	17	12	2	47	73	151
Flautist	1	0	0	1	0	2
Stuffed toy	0	0	0	0	2	2
Postage stamp	0	0	1	0	0	1
Clip art	0	3	0	0	0	3
Visual arts	34	48	327	1116	32	1557
Cityscape	2	0	0	5	0	7
Road	1	0	0	0	0	1
Wall	1	0	0	0	3	4
Hall	0	0	0	1	0	1
Classical sculpture	0	0	0	0	263	263
Biome	1	0	0	9	0	10
First-rate	1	0	0	1	0	2
Lawn ornament	0	0	0	0	30	30
Comics	0	2	0	0	0	2
Monarch	2	0	15	80	0	97
Grove	0	1	0	0	0	1
Anime	0	0	0	0	1	1
Psychedelic art	0	0	0	3	0	3
Shore	0	0	0	6	0	6
Mansion	0	0	0	2	0	2
Child art	1	0	0	11	0	12
Hill	0	1	0	3	0	4
Pankration	1	0	0	0	0	1
Cylinder	0	0	0	1	0	1
Vernissage	0	0	1	0	0	1
Musical instrument	0	0	0	6	0	6
Christmas	0	0	1	0	0	1
Lip	0	0	1	2	0	3
Park	0	0	0	0	2	2
Lamp	0	0	0	0	2	2
Tapestry	1	9	77	24	0	111
Roman temple	1	0	0	0	0	1
Darkness	0	0	0	9	0	9
Log cabin	0	0	0	2	0	2
Wetsuit	0	0	0	1	0	1
Ballet dancer	0	0	0	1	2	3
Crew	0	1	0	0	0	1
Stately home	1	1	0	6	0	8
Wicker	0	0	0	0	1	1
Silk	0	0	0	1	0	1
Gondola	3	3	0	4	0	10
Sand	0	0	0	1	6	7
Ballroom	0	0	0	1	0	1
Junk food	0	0	0	1	0	1
Fur	3	0	0	1	0	4
Tuxedo	0	0	0	7	0	7
Hay	0	0	0	1	0	1
Giraffidae	0	0	0	0	1	1
Channel	1	0	0	0	0	1
Orchestra	0	0	0	1	0	1
Stitch	0	0	1	0	0	1
Label	0	0	0	2	0	2
Tile	0	0	1	2	0	3
Wrinkle	0	1	0	0	0	1
Guru	0	0	18	0	1	19
Environmental art	0	0	0	1	23	24
Altar	0	0	3	1	0	4
Fog	0	0	0	1	0	1
Airline	0	0	0	1	0	1
Sporting Group	0	0	0	1	2	3
Sailboat	0	3	0	8	0	11
Loggerhead sea turtle	0	1	0	0	0	1
Valley	0	0	0	2	0	2
Arthropod	0	1	0	0	0	1
Snow	3	0	0	4	1	8
Monochrome	4	13	0	0	4	21
Pedestal	0	0	0	0	1	1
Pilgrims	1	0	0	26	0	27
Suspension bridge	0	1	0	0	0	1
Port	0	0	0	7	0	7
Obelisk	1	0	0	0	1	2
Cuisine	0	0	0	2	0	2
Traditional sport	0	1	0	0	0	1
Monument	3	1	0	0	178	182
Floor	0	0	0	1	1	2
Tartane	0	1	0	0	0	1
Wedding dress	0	0	0	1	0	1
Pope	0	1	5	5	0	11
Smile	1	1	0	63	0	65
Mosaic	0	0	38	2	1	41
Forest	2	1	0	8	0	11
Military person	0	0	0	1	0	1
Airplane	0	0	0	1	0	1
Yard globe	0	0	0	0	1	1
Adaptation	2	7	1	7	2	19
Fish	0	0	0	0	1	1
Waterway	14	7	0	31	1	53
Penteconter	0	1	0	0	0	1
Lighting	0	0	0	0	1	1
Nurse	0	0	0	1	0	1
Grass	1	2	0	9	42	54
Furniture	3	0	4	17	9	33
Cupid	0	0	0	5	2	7
Spear	0	1	0	0	0	1
Food	0	0	0	2	0	2
People	2	2	0	5	0	9
Collection	1	2	13	4	0	20
Old-growth forest	0	1	0	4	0	5
Graphics	0	0	0	2	0	2
Jungle	0	0	0	1	0	1
Rhinoceros	0	1	0	0	2	3
Calligraphy	0	0	0	1	0	1
Freight transport	0	0	0	2	0	2
Computer accessory	0	0	0	1	0	1
Skeleton	0	0	0	0	2	2
Mane	1	0	0	0	1	2
Arm	5	0	0	0	6	11
Folk dance	0	0	0	2	0	2
Table	2	0	0	1	2	5
Manila galleon	1	0	0	0	0	1
Cross-stitch	0	0	8	0	0	8
Shar pei	0	0	0	0	2	2
House	3	10	0	14	4	31
Fashion	2	1	0	111	0	114
Creative arts	0	0	1	0	0	1
Ecoregion	0	0	0	13	0	13
Portrait	78	18	64	1539	3	1702
Iron	1	0	0	0	1	2
Highland	0	1	0	4	0	5
Big cats	0	0	0	0	2	2
Perching bird	0	0	0	1	0	1
Glacial landform	0	1	0	0	0	1
Swan	0	0	0	0	1	1
Mosque	1	0	0	0	0	1
Rope climbing	0	0	0	0	1	1
Arch	3	7	5	2	0	17
Skull	0	2	0	0	2	4
Grass family	1	0	0	4	0	5
Geological phenomenon	0	0	0	10	0	10
Art model	6	0	0	6	0	12
Cossacks	0	0	0	1	0	1
Sleeve	0	0	0	1	1	2
Pole	0	1	0	2	0	3
Conversation	0	0	0	1	0	1
Watercolor paint	28	8	6	103	0	145
Banknote	0	1	0	0	0	1
Composer	0	0	0	1	0	1
Felidae	0	1	0	0	4	5
3d modeling	0	0	0	0	1	1
Coin	0	0	0	2	0	2
White	0	0	0	1	2	3
Clothing	0	0	0	3	1	4
Brown hair	0	0	0	2	0	2
Event	1	0	1	18	0	20
Estate	0	0	0	5	0	5
Frigate	1	7	0	8	0	16
Northern hardwood forest	0	1	0	6	0	7
Western riding	0	0	0	4	0	4
Sunlight	0	0	0	1	0	1
Castle	1	1	0	1	1	4
White rhinoceros	0	0	0	0	1	1
Prophet	1	15	463	146	1	626
Sculpture	2	0	2	7	495	506
Beard	6	5	18	24	0	53
Ship of the line	1	2	0	1	0	4
Tableware	0	0	0	14	0	14
Landmark	1	12	0	0	25	38
Reading	1	0	0	17	0	18
Glasses	0	1	0	1	0	2
Still life photography	0	1	0	6	7	14
Invertebrate	0	1	0	0	0	1
Electronic device	0	0	0	1	0	1
Motorcycle	0	0	0	1	0	1
Fortification	0	0	0	0	1	1
Atmospheric phenomenon	2	0	0	30	1	33
Pug	0	0	0	1	0	1
Shelf	0	0	0	0	1	1
Neck	1	0	1	5	3	10
Whippet	1	0	0	0	0	1
Lawn mower	0	0	0	0	1	1
Shoulder	2	0	0	0	7	9
Skin	0	0	1	0	2	3
Brass	0	0	3	2	8	13
Beige	0	0	0	3	0	3
Plate	0	0	0	19	0	19
Sorrel	1	0	0	0	0	1
Wind wave	0	0	0	3	0	3
Turban	0	0	0	1	0	1
Ice	0	0	0	0	2	2
Arcade	1	4	0	0	0	5
Air travel	0	0	0	1	0	1
Panorama	0	1	0	7	0	8
Headpiece	0	0	0	22	1	23
Easel	0	0	1	0	0	1
Chest	3	2	0	2	3	10
World	0	2	0	1	4	7
Water transportation	0	1	0	3	0	4
Aerospace engineering	0	0	0	1	0	1
Porcelain	0	0	0	5	1	6
Extinction	0	0	0	0	1	1
Bonnet	1	0	0	1	0	2
Metropolitan bishop	0	0	8	4	0	12
Wind	0	0	0	8	1	9
Joint	3	0	0	0	15	18
Church	0	5	1	0	0	6
Monolith	0	0	0	0	1	1
Insect	0	1	0	0	0	1
Owl	0	1	0	0	3	4
Viaduct	0	1	0	0	0	1
Cash	0	0	1	0	0	1
Marsh	0	0	0	1	0	1
Photographic paper	0	1	0	0	0	1
Bass violin	0	0	0	1	0	1
Boating	0	2	0	0	0	2
Exhibition	0	0	1	0	0	1
Basilica	1	2	1	2	0	6
Vertebrate	0	0	0	3	0	3
Alcohol	0	0	0	1	0	1
Child	2	0	2	162	1	167
Sitting	16	3	0	43	20	82
Physicist	0	2	0	0	0	2
Fiddle	0	0	0	1	0	1
Cart	0	1	0	3	0	4
Gesture	2	0	0	3	2	7
Sunflower	0	0	0	1	0	1
Massif	0	1	0	0	0	1
Pottery	0	0	0	0	1	1
Urban design	0	0	0	0	2	2
Oval	0	2	1	64	0	67
Holiday	0	0	1	1	0	2
Claw	0	0	0	0	1	1
Sea turtle	0	1	0	0	0	1
Rim	0	1	0	0	0	1
Sheep	0	1	0	0	0	1
Historian	1	1	0	11	0	13
Pest	0	1	0	0	0	1
Daughter	0	0	1	1	0	2
Sky	4	2	0	104	29	139
Wildflower	0	0	0	1	0	1
Fashion illustration	2	0	0	0	0	2
Temple	0	0	12	2	7	21
Mode of transport	0	0	0	1	0	1
Spoke	0	1	0	0	0	1
Facial expression	0	0	0	0	1	1
Stage	0	0	0	1	0	1
Monochrome photography	1	0	0	1	3	5
Leg	8	0	0	1	10	19
Ironclad warship	0	2	0	0	0	2
Classic car	0	1	0	0	0	1
Musical ensemble	0	0	0	1	0	1
Ground beetle	0	1	0	0	0	1
Cliff	1	1	0	10	0	12
Hand	1	0	1	1	11	14
Mother	0	0	1	2	0	3
Action figure	0	0	0	0	2	2
Eyebrow	4	1	0	96	0	101
Chair	0	0	0	0	2	2
Machine	0	0	0	0	2	2
Tattoo	0	0	2	0	0	2
Saluki	0	0	0	1	0	1
Bronze sculpture	0	0	0	0	151	151
Greyhound	1	0	0	0	0	1
Rock	1	1	0	14	35	51
Fawn	0	0	0	0	1	1
Auto part	0	0	0	0	1	1
Dog breed	0	0	0	2	1	3
Hand fan	1	0	0	2	0	3
Urban area	0	0	0	0	2	2
Boat	2	19	0	31	0	52
Saddle	0	0	0	2	0	2
Shrub	0	0	0	1	0	1
Town square	1	0	0	0	0	1
Sea	0	0	0	29	2	31
Headgear	3	3	2	15	1	24
Shrine	0	0	12	0	0	12
Hair	5	1	1	9	1	17
Reining	0	0	0	2	0	2
Tourist attraction	1	0	6	9	9	25
Meerkat	0	0	0	0	1	1
Horse	1	3	0	114	13	131
Tropical and subtropical coniferous forests	0	1	0	2	0	3
Dressage	0	0	0	2	0	2
String instrument	0	0	0	2	0	2
Warship	0	1	0	0	0	1
Outdoor furniture	0	0	0	0	2	2
Dreadnought	0	1	0	0	0	1
Loch	0	0	0	4	0	4
Ridge	0	0	0	1	0	1
Metal	1	1	5	6	156	169
Army men	0	0	0	0	1	1
Plucked string instruments	0	0	0	2	0	2
Home	1	1	0	5	1	8
Kangaroo	0	1	0	0	1	2
Statue	0	0	6	2	402	410
Cope	0	0	13	1	0	14
Sunrise	0	0	0	3	0	3
Byzantine architecture	0	2	0	0	0	2
Alps	0	1	0	0	0	1
Rectangle	0	1	5	5	0	11
Plain	0	0	0	12	0	12
Robe	0	0	0	3	1	4
Geology	0	1	0	3	3	7
Music	0	0	0	2	0	2
Glass bottle	0	0	0	1	0	1
Rust	0	0	0	1	0	1
Stallion	1	0	0	7	6	14
African elephant	0	0	0	0	2	2
Whiskers	0	1	0	0	0	1
Property	0	0	0	1	1	2
Choir	0	0	0	1	0	1
Armour	0	1	0	6	0	7
Bowed string instrument	0	0	0	2	0	2
Woodwind instrument	0	0	0	1	0	1
Comb over	0	0	0	1	0	1
Veena	0	0	1	2	0	3
Dusk	0	0	0	1	0	1
Throwing	0	0	0	0	1	1
Figurine	0	0	0	98	206	304
Troop	0	0	0	2	0	2
Dobermann	0	1	0	0	0	1
Botany	3	0	0	0	31	34
Locket	0	0	1	12	0	13
Human anatomy	0	0	0	0	2	2
Miniature	1	5	235	0	3	244
Peach	0	0	1	0	0	1
Number	0	0	0	1	0	1
Spire	0	3	0	0	0	3
Worship	0	0	1	0	0	1
Formation	0	0	0	0	2	2
Nativity scene	0	0	6	6	0	12
Christmas ornament	0	0	1	0	0	1
English lavender	0	0	0	1	0	1
Pineapple	0	0	0	1	0	1
Mural	1	1	16	41	0	59
Aerial photography	0	1	0	0	0	1
Pedestrian	0	0	0	1	0	1
Anthropology	0	0	0	0	2	2
Sailing	0	4	0	5	0	9
Sidewalk	0	0	0	0	1	1
Atmosphere	0	0	0	15	0	15
Wing	0	0	0	2	7	9
Mountain range	0	2	0	1	0	3
Artifact	0	0	5	1	10	16
Steel	0	0	0	0	1	1
Monarchy	0	0	4	7	0	11
Freezing	0	0	0	0	2	2
Red juniper	0	0	0	1	0	1
Coachman	0	0	0	1	0	1
Rural area	2	0	0	11	0	13
Textile	1	11	70	26	0	108
Ship	0	7	0	12	0	19
Magenta	0	0	1	1	0	2
Viking ships	0	1	0	0	0	1
Marine biology	0	0	0	0	1	1
Art	140	203	743	1967	493	3546
Font	0	6	3	8	1	18
Military uniform	0	0	0	1	0	1
Mountain	0	2	0	5	0	7
Sandal	0	0	0	0	1	1
Elder	0	0	5	30	0	35
Ceiling	0	0	0	6	0	6
Horse harness	0	0	0	1	0	1
Cottage	0	1	0	0	0	1
Ornament	0	0	0	2	1	3
Photograph	5	3	0	5	0	13
Ballet	0	0	0	1	0	1
Dolphin	0	0	0	0	1	1
Screenshot	0	0	0	1	0	1
Interior design	0	1	5	10	1	17
Bamboo	0	0	0	0	1	1
Poster	1	4	55	2	1	63
Daytime	0	0	0	2	0	2
Ancient history	2	6	3	1	6	18
Design	0	0	1	2	3	6
Archimandrite	0	0	2	5	0	7
Long hair	2	0	0	7	1	10
Net	0	0	0	0	1	1
Viking	0	0	1	0	0	1
Meteorological phenomenon	0	0	0	1	0	1
Fontange	1	0	0	11	0	12
Fun	0	0	0	0	1	1
Downtown	0	0	0	0	1	1
Animal sports	0	1	0	6	0	7
Orange	0	0	0	1	0	1
Leisure	0	0	0	0	3	3
Ice skating	0	0	0	1	0	1
Pine	0	0	0	1	0	1
Sea otter	0	0	0	1	0	1
Demolition	0	0	0	0	1	1
Land lot	1	0	0	1	0	2
Paper product	7	16	0	1	0	24
History	18	100	184	62	5	369
Hot air balloon	0	1	0	0	0	1
Religious item	0	0	126	1	0	127
Symbol	0	0	2	0	1	3
Religious institute	0	0	13	1	0	14
Hill station	0	0	0	1	0	1
Public event	0	1	0	0	0	1
Pond	0	0	0	4	0	4
Common bottlenose dolphin	0	0	0	0	1	1
Costume hat	0	1	0	0	0	1
Canidae	1	1	0	9	9	20
Mission	0	1	0	0	0	1
Bridge	5	2	0	0	0	7
Bird	0	3	0	2	4	9
Acrylic paint	0	0	1	44	0	45
Clock	0	1	0	0	0	1
Pier	1	0	0	3	0	4
Shimada	1	0	0	0	0	1
Plastic arts	0	0	0	1	0	1
Walk-behind mower	0	0	0	0	1	1
sunflower	0	0	0	1	0	1
Vintage advertisement	0	1	0	0	0	1
Building sand castles	0	0	0	0	4	4
Jumping	0	0	0	0	1	1
Elephants and Mammoths	0	0	0	0	3	3
Supernatural creature	0	1	6	2	0	9
Motif	0	0	0	1	0	1
Deer	0	0	0	0	1	1
Self-portrait	64	10	11	869	0	954
Samurai	0	1	0	0	0	1
Marble	0	0	1	0	19	20
Scene	0	0	0	2	0	2
Sloop	0	1	0	0	0	1
Games	0	2	1	13	3	19
Dance	0	0	0	2	1	3
Macropodidae	0	1	0	0	1	2
Mountainous landforms	0	2	0	1	0	3
Meadow	0	0	0	4	1	5
Ceramic	0	0	0	0	9	9
Mythology	7	44	37	322	19	429
Pond turtle	0	1	0	0	0	1
Mount scenery	0	0	0	1	0	1
Bank	6	0	0	31	0	37
Patriarch	0	0	17	3	0	20
Elephant beetle	0	1	0	0	0	1
Galleon	1	2	0	4	0	7
Painting	72	52	592	1952	0	2668
Glass	0	0	2	1	5	8
Wheel	0	0	0	0	1	1
Vegetation	0	0	0	2	0	2
Wire	0	0	0	1	0	1
Light	0	0	0	2	1	3
Doll	0	0	0	99	0	99
Meditation	0	0	0	0	1	1
Portrait photography	0	0	0	2	0	2
Pre-dreadnought battleship	0	1	0	0	0	1
Gown	0	0	0	107	0	107
Tourism	0	0	0	11	3	14
Grassland	0	0	0	8	1	9
woodworking	0	0	0	0	1	1
